444441|16
444442|25
444443|21
444444|24
444445|25
444446|31
444447|19
444448|25
555551|2
555552|1
555553|1
555554|1
555555|1
555556|1
555557|3
555558|1
555559|1
444449|14
444450|29
444451|10
555560|1
444452|29
555561|5
555562|1
555563|1
555564|1
555565|1
555566|1
444453|10
444454|15
444455|7
444456|0
555567|1
555568|1
555569|1
444457|7
555570|1
555571|2
444458|20
555572|1
555573|1
555574|1
555575|1
555576|1
555577|1
555578|1
